15 10
WWWWWWWWWWWWWWW
Wd0000000D000WW
WWW0W0WW0We00WW
W0W0W0WW0WW00WW
WaW0WWWW0WG00WW
WS0A00WW0WWWEWW
W00WW0WW0W0000W
Wb0WW0WWWWWWCWW
W00WW0B000000cW
WWWWWWWWWWWWWWW
